11111111111111
100000000000P1
10000000000001
10000000000001
10000000000001
10000000000001
10000000000001
11111000111111
11111000011111
111110000000C1
11110000011111
10000000000001
100000000000E1
11111111111111
