11111111111111111111111111111
10CC000000000001C0000C000E001
111C000C000000011100000000001
1000000100000000C0000C0000001
1C000101000000C00000000001111
10000101C00000001000000001111
10000111000000001PY0000000001
11111111111111111111111111111
