11111111111111111111111111111
1000000000000001000000000E001
11110000000000011100000000001
10000000000000000000000000001
10000000000000000000000001111
10000100000000001000000001111
10000100000000001000000000P01
11111111111111111111111111111
