11111111111111111111111111111
1E00000000000000C0000C0000001
1000000C000000000000000000001
1P000000000000C00000000001111
10000100C00000001000000000011
10000100000000001000000000011
11111111111111111111111111111

