11111111111111111111111111111
1000000C000100C00000000000001
10000000000100000000000000001
1P000000000110001000000001111
10000100000000C01000000000011
10000100000000001000000000011
11111111111111111111111111111