11111111111111111111111111111
10CC000000000001C0000C000E001
111C000C000000011100000000001
1000000000000000C0000C0000001
1C000000000000C00000000001111
10000100C00000001000000001111
10000100000000001000000000P01
11111111111111111111111111111